2000000000000000000000000000000000000000
0000000000000000000000000000000000000000
0000000000000000000000000000000000000000
0000000000000000000000000000000000000000
0000000000000000000000000000000000000000
0000000002222222222222222222222000000000
0000000002111111111111111111112000000000
0000000002111111111111111111112000000000
0000000002111111111111111111112000000000
0000000001111111111111111111112000000000
0000000001111111111111111111112000000000
0000000001111111111111111111112000000000
0000000002111111111111111111112000000000
0000000002111111111111111111112000000000
0000000002111112222222222222222000000000
0000000002111112111111111111112000000000
0000000002111112222222222221112000000000
0000000002111111111111111111112000000000
0000000002222222222222222222222000000000
0000000000000000000000000000000000000000
0000000000000000000000000000000000000000
0000000000000000000000000000000000000000
0000000000000000000000000000000000000000
0000000000000000000000000000000000000000
0000000000000000000000000000000000000000
0000000000000000000000000000000000000000
0000000000000000000000000000000000000000
0000000000000000000000000000000000000000
0000000000000000000000000000000000000000
0000000000000000000000000000000000000000
0000000000000000000000000000000000000000
0000000000000000000000000000000000000000
0000000000000000000000000000000000000000
0000000000000000000000000000000000000000
0000000000000000000000000000000000000000
0000000000000000000000000000000000000000
0000000000000000000000000000000000000000
0000000000000000000000000000000000000000
0000000000000000000000000000000000000000
0000000000000000000000000000000000000000