00000000000000000000
00000000000000000000
00000000000000000000
00000000000000000000
00000000000000000000
00000022222222000000
00000021111112000000
00000021111112000000
00000021111112000000
00000011111111000000
00000011111111000000
00000011111111000000
00000021111112000000
00000021111112000000
00000021111112000000
00000022222222000000
00000000000000000000
00000000000000000000
00000000000000000000
00000000000000000000